1111111111111
10010C0000001
100001E111001
1P00110000011
1111111111111
