1111111111111
10010000000C1
100001E111001
1P00110CC0011
1111111111111
