1111111
10EP111
1000111
100C101
1111111
