1111111
10E0111
1000111
100C0P1
1111111
