111111111111111
1E000000C000001
1000000000000P1
111111111111111