1111111
1P0C0C1
10C0CE1
11111111
